"a" = (/turf,/area)
"b" = (/Dock,/turf,/area)
"c" = (/HomeIsland,/turf,/area)
"d" = (/turf/Island,/area)

(1,1,1) = {"
aaaaaaaaaaaaaaaaaaaaaaaaaaaaaaaaaaaaaaaaaaaaaaaaaa
aaaaaaaaaaaaaaaaaaaaaaaaaaaaaaaaaaaaaaaaaaaaaaaaaa
aaaaaaaaaaaaaaaaaaaaaaaaaaaaaaaaaaaaaaaaaaaaaaaaaa
aaaaaaaaaaaaaaaaaaaaadddddaaaaaaaaaaaaaaaaaaaaaaaa
aaaaaaaaaaaaaaaaaaaaddddddddaaaaaaaaaaaaaaaaaaaaaa
aaaaaaaaaaaaaaaaaaadddddddddaaaaaaaaaaaaaaaaaaaaaa
aaaaaaaaaaaaaaaaaaadddddddddaaaaaaaaaaaaaaaaaaaaaa
aaaaaaaaaaaaaaaaaaaaddddddddaaaaaaaaaaaaaaaaaaaaaa
aaaaaaaaaaaaaaaaaaaadddddddaaaaaaaaaaaaaaaaaaaaaaa
aaaaaaaaaaaaaaaaaaaadddddddaaaaaaaaaaaaaaaaaaaaaaa
aaaaaaaaaaaaaaaaaaaabddddddaaaaaaaaaaaaaaaaaaaaaaa
aaaaaaaaaaaaaaaaaaaaaaddddaaaaaaaaaaaaaaaaaaaaaaaa
aaaaaaaaaaaaaaaaaaaaaaddddaaaaaaaaaaaaaaaaaaaaaaaa
aaaaaaaaaaaaaaaaaaaaaaaaaaaaaaaaaaaaaaaaaaaaaaaaaa
aaaaaaaaaaaaaaaaaaaaaaaaaaaaaaaaaaaaaaaaaaaaaaaaaa
aaaaaaaaaaaaaaaaaaaaaaaaaaaaaaaaaaaaadddddddaaaaaa
aaaaaaaaaaaaddaaaaaaaaaaaaaaaaaaaaaaaddddddddaaaaa
aaaaaaaaaaadddaaaaaaaaaaaaaaaaaaaaaaaaabddddddaaaa
aaaaaaaaaaddddaaaaaaaaaaaaaaaaaaaaaaaaaaaddddddaaa
aaaaaaaaaddddaaaaaaaaaaaaaaaaaaaaaaaaaaaaaadddddaa
aaaaaaaaaddddaaaaaaaaaaaaaaaaaaaaaaaaaaaaaaaddddaa
aaaaaaaaddddbaaaaaaaaaaaaaaaaaaaaaaaaaaaaaaaadddaa
aaaaaaaadddaaaaaaaaaaaaaaaaaaaaaaaaaaaaaaaaaadddaa
aaaaaaaadaaaaaaaaaaaaaaaaaaaaaaaaaaaaaaaaaaaadddaa
aaaaaaaaaaaaaaaaaaaaaaaaaaaaaaaaaaaaaaaaaaaaadddaa
aaaaaaaaaaaaaaaaaaaaaaaaaaaaaaaaaaaaaaaaaaaaadddaa
aaaaaaaaaaaaaaaaaaaaaaaaaaaaaaaaaaaaaaaaaaaaaddaaa
aaaaaaaaaaaaaaaaaaaaaaaaaaaaaaaaaaaaaaaaaaaadddaaa
aaaaaaaaaaaaaaaaaaaaaaaaaaaaaaaaaaaaaaaaaaaadddaaa
aaaaaaaaaaaaaaaaaaaaaaaaaaaaaaaaaaadaaaaaaaadddaaa
aaaaaaaaaaaaaaaaaaaaaaaaaaaaaaacdddddaaaaaaadddaaa
aaaaaaaaaaaaaaaaaaaaaaaaaaaaaaaddddddaaaaaaadddaaa
aaaaaaaaaaaaaaaaaaaaaaaaaaaaaaaddddddaaaaaaddddaaa
aaaaaaaaaaaaaaaaaaaaaaaaaaaaaaaddddddaaaaaaddddaaa
aaaaaaaaaaaaaaaaaaaaaaaaaaaaaaadddbaaaaaaaaddddaaa
aaaaaaaaaaaaaaaaaaaaaaaaaaaaaaaaaaaaaaaaaadddddaaa
aaaaaaaaaaaaaaaaaaaaaaaaaaaaaaaaaaaaaaaaaadddddaaa
aaaaaaaaaaaaaaaaaaaaaaaaaaaaaaaaaaaaaaaaaddddddaaa
aaaaaaaaaaaaaaaaaaaaaaaaaaaaaaaaaaaaaaaadddddddaaa
aaaaaaaacddddaaaaaaaaaaaaaaaaaaaaaaaaaadddddddaaaa
aaaaaaaaddddddaaaaaaaaaaaaaaaaaaaaaaaaadddddddaaaa
aaaaaaaadddddddaaaaaaaaaaaaaaaaaaaaaaaaaddadddaaaa
aaaaaaaaaddddddaaaaaaaaaaaaaaaaaaaaaaaaaaaadddaaaa
aaaaaaaaaaadddbaaaaaaaaaaaaaaaaaaaaaaaaaaaabddaaaa
aaaaaaaaaaaaaaaaaaaaaaaaaaaaaaaaaaaaaaaaaaaaaaaaaa
aaaaaaaaaaaaaaaaaaaaaaaaaaaaaaaaaaaaaaaaaaaaaaaaaa
aaaaaaaaaaaaaaaaaaaaaaaaaaaaaaaaaaaaaaaaaaaaaaaaaa
aaaaaaaaaaaaaaaaaaaaaaaaaaaaaaaaaaaaaaaaaaaaaaaaaa
aaaaaaaaaaaaaaaaaaaaaaaaaaaaaaaaaaaaaaaaaaaaaaaaaa
aaaaaaaaaaaaaaaaaaaaaaaaaaaaaaaaaaaaaaaaaaaaaaaaaa
"}
